***************
*......*......*
*......*.....**
*......*....*.*
*......*..**..*
*.......*.**..*
*......*....*.*
*.....*......**
*....*........*
***************
