***************
*111111*222222*
*111111*22222**
*111111*2222*3*
*111111*22**33*
*1111111*2**33*
*111111*2222*3*
*11111*222222**
*1111*22222222*
***************
